R 2100 720

NO ./images/wall_sw_1.XPM
SO ./images/wall_sw_2.XPM
WE ./images/wall_sw_3.XPM
EA ./images/wall_sw_4.XPM
S  ./images/sprite.XPM

C 0,0,0
F 90,90,230

        1111111111111111111111111
        100000000011000000S000001
        1011000001110000000000001
        1001000000000000000200001
111111111011000001110000000000001
100000000011000001110111111111111
11110111111111011100000010001
11110111111111011101010010001
11000000110101011100022012221
10000000000000001100000000001
10000000000000001101010012221
1100000111010101111101110000111
11110111 1110101 101111010001
11111111 1111111 111111111111
